/---\
|   |  /----\
| /-+--+-\  |
| | |  | |  |
\-+-/  \-+--/
  \------/   